level_0:
11111111
1s22odf1
11111111

level_1:
1111111
1s0o2d1
12220f1
1111111


